111111112111111
111121111111121
111121111121111
111121212122112
122111211111111
111111111121211
111212111111211
111211111121211
111212111111111
111111112111221
211221212121111
111121111121111
121111111121111
111111211111111
