1111111111111111
1222222221111222
1111111111111111
1211111111111111
1111112111121111
1222122222221111
1111111111111111
2111222112222221
1111111111111111
2122221222111122
1121111121111111
1111111111122221
1121111121111111
1111111111122221
