11111111112222211111
11111111111111111111
11112211111111111111
11112212222112112221
11111111111111111111
11111111122111211111
11112221122111211211
11112211111111211111
11111111111111211111
11111111112221211111
11122222111111111111
11111121111111111111
21222121122112211211
21222121122112211211
21122111111111111111
22122111111111111111
22122111211111112111
21111111111111111111
22222111111111111111
